........................
........................
........................
........................
........................
........................
........................
........................
........................
........................
......................##
...##......##.......####
########################
########################
########################
