........................
........................
........................
........................
........................
........................
........................
........................
........................
......................C.
...C.......C........M.##
.C.##..C...##..M.C..####
########################
########################
########################
